↖↖↖↖↖↖→→↖↖↖→→→→↖↖↖↖↖→→→→→↖→↖↖↖→→↖→↖↖↖↖↖↖→↖↖↖↖↖↖→↖→→↖↖→→→↖↖→→↖↖↖→↖→→↖→→→→→↖↖↖→↖↖→↖↖↖↖→→→→↖↖↖↖→→→→→→→→→→↖↖↖→→↖→↖↖↖↖↖↖↖↖→→→
↘←←←←←←←←←←←←←↘←←←←←↘↘←↘↘↘↘↖←←←←←←↘↘←←←←↘↘↘←←←↘↘↘↘↘↘↘↘←←←←←↘↘↘←←←←↘←↘↘↘↘↙←↖↖→↖↗↖↘↘↘↘←↘↘↘←←←←↘↘↘↘↘↘↘↘↘↘↘↘↘↘↘↘↘←←←←←←←←↘↘↘
↘←←←←←←←←←←←↘←↘←←←←←←←↘←←↘→→↘↘←←←←↘←←←←←↘↘↘↘←←↘↘↘↖↘↘↘↖↖↖←↙←←↘↘←←←←↖↘↘↖←↘↙←←←↘←←↘↘↘↘↘↘←↘←←←←↘↘↘↘↘↘↘↘↘↘↘↖↘↘↘↘↘←←←←←←←←←↘↘↘
↖←←←←←←←←←←←←←↘↘←←←←←←↘↘←←←↘↘↘←←←←←←←←←↘↘↘↘↘↘←↘↘→→→→→→↖↖→↖←←↘↘↖←←←←←→↘↘↘↖←←↘↙←←↘↘↘↘↘↖←↘↘←←←↘↘↘↘↘↘↘←←→→↘↘↘↘↘↗↖↖↖↖←↘↙←←←↘↘
↘←←←←←←←←←←←←←↘↘←←←←←←↘↘↘←←↘↘↘←←←←←←←←←←←↘→↘↘↘←←←→→→→→↖↖→↘↘←↘↘↘←←←←↘↘↘←↘↖←←↘←←↘↘↘→→→↘↘↘←←←←↘↘↘↘↘↘↖↖↖→↘↘↘↘↘→→↖↖↖↖↖↘↖←←←←↘
↘←←←←↘←←↙←←←←←↘↘←←←←←←←↘↘↘←↘↘↘↘←←←←←←←←←←←→→→↗↖←←↘↘↘→↖→↘↘↘↘↘←↘←←←←←←↘←←↘↘↘←←←←←↘↘→→→↘↘↘←←←←↘↘↘→→→→↖←↘↘→↘↘→→↖↖↖↖↖↘↘↘←←←←↘
↖←←←↘↘←←←←←←←←←←←←←←←←←↘↘↘←←↘↘↘↘←←←←←←←←←←↖→→→↘←←←↘↘←←↘↘↘↘↘↘↘←←←←←←↘↘←←←←←←←←←→↘↘↘→→→↘↙←↘←←↘↘→→→→→↖↘→→→→→→↖↖↖↖↘←↘↗↖←←←←↘
→↖↖←←←←←←←↘↘↘↘←←←←←←←←←↘↘←←↖←↘↘↘↘←←←←←←←←←←↘↘↘↘↘←←↘←←←↘↘↘↘↘↘↘←←←←↘←↘↘←←←←←←←←←↘↘↘←↘↘↘→↖↘↘↘←←↘↘↘↘↘→→↗→→→→→→↖→↖→↗↖→→→↖↖←←→
↘↘←←←←←↖↖←↘↘↘↘↘↘←←←←↘←↘↘←←←←↘↘↘↘↘←←←←←←←←←↘↘↘↘↘↘↘←↘←←↘↘↘↘↘↘↘↘←←←↘↘↘↘←←←←←↘←←←←↘↘↘←↘↘→→→↘↘↘←←←↘←←→→→→→↖→→→→↖→↖→→→→→→↖←←←↘
↘↘↘←←←↖↖←↘↘←←←↘↘↘←←←↘←←↘←←←←↘↘↘↘↘↖←←←←←←←←↘↘↘↘↘↘↘↘↘←←↘↘↘↘↘↘↘←←←←←↘↘←←←←←←←←←←←←↘↘←←↘→→→→→↘↘←←←←←↖→→→↖→→→→→↖→→→→→→↖→↘↘↘←↘
↘←←←←←↖↖↘↘↘↘←←↘↘↖←←←←←←↘←←←←↘↘↘↘←←↖←←←←←←←←←↘↘↘↘↘↘↘←↘↘↘↘↘↘↘↘←←←←←←←←←←←←←←←←←←←↘←←←→→→→→→→↗↗↖↖←←←←→→↘↘↘→→↖↖→→→→→→↘↘↘↘↘↘↘
↖←←←←←←←↘↘↘↖←←↘↘←←↖↖↖↖↘↘←↖←←↘↘↘↙←←←↘←←←←←←←←←↘↘↘↘↘↘←↘↘←↘↘↘↘↘←←←←←←←←←←←↘←←←←↖←↘↘←←←↖↖→→→→→→→↖↖←←↖←↘↘↘↘↙←←↘←↘↘↘↘↘↘↘↘↘↘↘↘↘
↖←←←←←←←↘↘↘←←←←↘←←↖↖↖↖→↖←←←←↘↘←←←←←↘↘←←←←←←←←↘↘↘↘↘↘←↘←←←↘→→↘↘←←←←←←←←←←←←←←←←←←←←←←↖↖→→→→→→→↘↘←←←←↘↘↘↘←←↘↖↖↘↘↘↘↘↘↘↘↘↘↘←↘
→→↖↖←←←↖←↘←←↘←←←←↖↖↖↘←↘↘←←←←↘↘←←←←←←↘←←←←←←←←↘↘↘↘↘↘←←↘↘←↘↘↘↘↘↙←↘↘←←←←←←←←←←↘←←←←↙←←↖↖→→↘↘↘↘→↘↘←←←←↘↘↘↘↖←↘↖↖→→↘↘↘↘↘↘↘↘←←↘
↖→→↖↖←←→↘↘←←↘←←←←←↖←↘↘←←↘↘↘↘↘←←←←←←←↘↖←←←←←←↘↘↘↘↘↘↘←←↘↘↖←↘↘↘↘←↘↘↘←←←←←←←←←↘↘←←←←←↖←←←↘↘↘↘↘↘↘↘↘↘←←↘↘←←←↘↘←←←↘↘→↘↘↘↘↘↘↘←↘←
←→→↖↖←←↘↘←↖→↘↖←←↖↖↖↖→↗↖←↘←↘↘←←←←←←←←←←←↘←←←↘↘↘↘↘↘↘←←↖→→↖←↘↘↘↘←↘↘↘←←←↙←←←←←←↘←←←←←←←←←↘↘↘↘↘↘↘→→↖↖←↘↘←←←↘↘←←←↘↘↘↘↘↘↘↘↘↘←↘←
←→→→↘←←↘↙←←↘→↖↖↖↖↖↖↘↘→→→↘←↘↘↘↘↘↘←←←←←←←←←←←←↘↘↘↘↘←←←←↘↘←←↘↘↘↘←↘↘↘←←←↖←←←←←←↘←←←←↖↖↖↖←↘↘↘↘↘↘↘↘↘→↘←↘↘↘←↘↘←←←←↘↘↘↘↘↘↘↘↘↘↘↘←
←←↘↘↘↙←↘↘←←→↖↖↖↖↖↖↘↘←←↘↘↘↘↘↖↘↘↘←←←←←←←←↘↘↘↘←↘↘↘↘↘←←←←←↘↘↘↘↘↘↘↖↘↘↘↘←←↖↖←←←←←←←←←←←↖↖←←↘↘↘↘↘↘↘↘↘↘↘↘↘↘←←↘↘←←←←↘↘↘↘↘↘↘↘↘↘↘↘←
←↘↘↘↘←←↘←←←→↖↖↖↖↖↘↘↘↘←↘↘↘←←↘↘↘↘↘←←←←←←←↘↘↘↘←←↘↘↘←←←←←←↖→↘↖↘→↘↘↘→→↗↖←←←↘←←←←↘←←←←←←←↘↘↘↖↘↘→→→↘↘↘↘↘↘↘←↘↘↘←←↘↘↘↘↘↘←←↘↘↘↘↘↘←
←↘↘↘↘←←←←←↖↖↖↖↖←↘↘↘↘↘←↘↘↘←←←↘→→↘↘←←←←←←↘↘←↘←←↘↘←←←←←←↖←↘↘↘↘↘↘↘↘↘→→↖↖←←↘←←←←←↖←←←←←←↘↘↘←↘↘→→→→→↖↘↘↘↘↘↘↘←←←↘↘↘↘↘↘↘←↘↘↘↘↘↘←
←↘↘↘↘←←↖←←↖↖↖↖←↘↘↘↘↘↘↘↘↘←←←↖↘→→→↖↖←←←←←↘←←←↖←↘↘↖↖←←←↖↖↘↘↘↘↘↘↘↘↘↘←↖↖↖↖↘↘←←←←←←↖←←←←←↘↘←←↘→↖→→→→→↘↘↘↘↘↘←←←↘↘↘↘↘↗↘↘↘↘↘↘↘→↗↖
←←↘↘↖↖↖↖←←←←←→↘↘↘↘↘↘↘↘↘←←←←←↘↘↘↘→↖↖↖↘←←←↖←←←→↖↘↘←←←←←←↘↘↘↘↘↗↖↘↘↘←←←↖↖→↖↖↖←←←←↖↖↖←←←↘←←←←↘↘↘↘↘↘→↘↘↘↘↘↘←←←↘↘↘↘←←↘↘↘↘↘↘↘↘↘↖
←←←→↖↖←↘←←←←↖→↘↘↘↘↘↙↘↘↗↖←←←←↗↘↘↖←↖↖↖↖↖↖↖↖↖↖↖→↘↘↘↖←↖↖↘←←←↘↘↘↖↘↘↘←←←↖↖↖↘↘←←←←←←←←←←←←←←←←←←↘↘↘↘↘↘↘↘↘↘↘↘←←↘↘↘↘↘←←←↘↘↘↘↘↘↘↘←
←↖↖↖→↘←↘←←←←←↘→↖↘↘↘↖↘→→↖↖←←←↘↘↘↘←←↖↖→↖↖↖↖↖↖↖↘↘↘→↖↖↖↖↘↙←←↘→↖↘↘↘↘←←↖↖↖↘↘↘↘←←←←←←←↘↘←←←←←←←←↘↘↘↘↘↘↘↘↘↘↘↘←←←↘↘↘↘↖←←↘↘↘↘↗↘↘↘←
↖↖↖←↘↘←←←↖↖←←↘←←↘↘↘↘↘↘←→↘↘←←←↘↘↘←←↖↖→→↖↖↖↖↖↖→↘↖↖↖↖↖↘↘↙←←↘↘↘↘↘→→↖↖↖←↘←↘→↗↖↖↖←←←←↘↘←←←←←←←←↘↘↘↘↘↘↘↘↘↘↘↘←←←↘↘↘←←↖←↘↘↘→→→→↗↖
↖↖→↘↘↘←←↖↖←←↘↘←←↘↘↘↘↘↖←←↘↘↘←←↘↘↖↖←←↖↖↗↖↖↖↖→↖→→↖←←←←↘↘↘←↘↘↘↘←←↘↘←←←↘←←←↘→↖←↘←←←←↘↘←←←←←←←←↘↘↘↘↘↘↘↘↘↘↘↘←←←←↘↘←←←←↘↘↘→→→→→↖
↖→→→↗↖↖↖↖←←←←↘↙←←↘↘↘↘→↖←↘↘↘←←←→→↖↖←↖↖↖→↖←↘←↘↘↘↘←←←←↘↘↘←←↘↘↘↘←←↘←←←←←←←←←↘↘↘←←←←←↖←←↘←←←←←↘↘↘→→→→↘↘↘↘↘↙←↖←↘↘↘←←←←↘↘←↘↘↘↘↙
↖→→→→→↖↖←←←↖↖→↖↖↘↘↘↙←↖→→↘↘↘↙←←←↖↖↖↖↖↖↖→↘↘↘↘↘←↘↘↖←↘↘↘←←←←↘↘↘↘←←←←←←←←←←←↘↘↘↘←←←←←←↖←→↖↖↖←↘↘↘↘↘↘↘↘↘↘↘↘↘↖←←↘↘↘↘↘↘←←↘↘↘↘↘↘↘↙
↖→→→→→↖↖←←←↖↖→→↖↘↘↘↖↖←↘↘↘↘↘←←←←←←↖↖↖↖←↘→↘↘↘↘←←↘↘↘↘←↘↘↘←←↘↘↘↘←←←↘←←←←←←←↘↘↘↖←↖←←←←←←↖↖↖↖←↘↘↘↘↘↘↘↘↘↘↘↘↘←←←↘↗↘↘↘↙←←↘→↘↘↘↘↘←
←→↘→→→→↖↗↖↖←↖↖→↘↘↘↘↖↖↘↘↘↘↘↙←←↖↖↖←↖↖↖←←←→→↘↘↘←←↘↘↘↖←↘↘↘↙↘↘↘↘←←←↘↘←←←←←←←→→→↖↖↖←↘←←←←←←←←←↘↘↘↘←↘↘↘↘↘↘↘↙←←←→→→→→↖↖↖↘→→↘↘↘↘←
←→→→→→→→→↖↖←←↘↘↘↘↘↖←←→↖→↘↘↖↖↖↖↖↖↖←←↖↖↖↖←→→→↖↖↖→→→→↖↖→↘↘↘↘←←←←←↘↘←←←←←←←↘→→↖↖↘↘↘↘←←←←←↘←←↘↘↘↘←↘↘↘↘↘↘↘↖↖↖↖→→→→→↖↖↖←↘↘→→↘↘↙
↖→→→→→→→→↖←←↘↘↘↘↘→→↖↖↘→→→→↖↖↖↖→→↖↖←←↖↖↖↘→→→→↖↖→→↘↘←←↘↘↖↘↖←←←↘↘↘←←←←←←←←←↘↙←←↘↘↘↙←←←←←↘↘←↘↘↘↘←↘↘↘↘↘←←←←↖↖→→→→→↖↖↖←↘↘→→→→↖
↖↘↘↘↘→→↖↘↘←←←↗↖↘↘→→←←→↖↘↘↖↖←←↖↖→↖↖↖↖↖↘↘←→→→→→→→→↘↖←←↘↘↘→→↖←←↘↘↘←←←←←←←←←↘←←←↘↘↘←←←←←←↘↘↘↘↘↘↘↘←↘↘↘↘←←←←←←→→→↘→↘↘↘←↘↘↘↘→→↖
←↗↗↗→→→↘↘↘↙←←→→→↙↖→↖←→→↘→↖→↖←↖↖↖↖↖↖↖↘↘↘←←↖→→→→↘↘→→→↙↘↘↘↘↘↘↘↘↘↘↘←←←←←←←←←↘←←←↘↘↘←←↘←←↘↘←↘↘↘↘↘↘←↘↘↘↘←←←←←←↘↘↘↘↘↘↘←↘↘↘↙←→→←
←→↖→→↘↘↘↘↘↙←←↖→→↖←→→↖↖→→↖↖→↖↖↖→↖↖↖↖↖↘↘↘↘←←↘↘↘↘→→↘←↘↘↘↘↗↖←↘↘↘↘↘↘↘←←←←←←←←←←←↘←←↘↘↘↘←←↘↘←←↘↘↘↘↘←↘↘↘↘←←←←←←←←↘↘↘↘↖↖→↖↘↖←↘↘↙
←←←↘↘↘↘↘↘↘↖←←←↘↘↘↘←←↖↖→→↖↖→→↖↖↖↖↖↖↖↘↘↘↘↘←←↘↘↘↘↘↘↘↘↘↘↘→→→↖↘↘↘↘↘↘↘←←←←↘←←←←←←←←↘↘↘↘↘←↘↘↘←←↘↘↘↘←↘↘↘↘↙←↖↖←←↘↘←←→→→↖→↘↘↘←←↘↘↖
←←↘↘↘↘↘↘↘↘←↖←←↘↘↘←←←↖↖→↖↖→→↖↖↖↖↖↖←←↘↘↘↘↘←↘↘←←↘↘↘↘↘↘↘←↘→→→↘↘↘↘↘↘←←←←←←←←←←←←←←↘↘↘↘↘↘↘↘↘←←↘↘↘↘↘↘↘↘←←↖↖↖↖←↘↖←←←↖→→→↘↗↗↖↘↘↘↖
↖←↘↘↘↘↘↘↘↖←↖↖↘↘↘←←←↖↖→→↖↖←↖↖↖↖↖↖↘↘←↘↘↘↘↘↘↘←←←↘↘↘↘←←↘←↖→→↘↘→→→→↖←←←←←↘←←←↘←←←←←↘↘↘←↘↘↘↘←←←←←↘↘↘↘←←←↖↖↖←←→↖↖↖↖↖→→→→→→↖→→→↖
↖↘↘↘↘↘↘↘→←←←←↘↘←←←←←←→→↖↖↖↖↖↖↖↖→↘↘↘↘↘↘←↘↘↘↘←↘↘↘↘↘←←←←←↘↘↘→→→→→→↖↘↘←←←↖←←←←←←←←↘↘↘←←↘↘↘←←←←↘↘↘↘←←←↖↖↖↖←←↖↖↖↖↖←↘↘↘→→→↘↘↘→↖
←↘↘↘↘↘↘↘↘↘↘←←↘↘←←↖↖↖↖→→↖↖↖↖←↘←←↘↘↘↘↘↘↗↘↘↘↘↘←←↘↘↘↘←←←←←↘↘→→→→→→→↘↘↖↖←←←←←↖↘↘←←↖↘↘←←←↘↘↖←←↖↘↘↘↘↗↖↖↖↖←←↘←↖↖↖↖↖←↘↘↘↘↘↘↘↘↘↘↘↙
←←↘↘↘↘↘↘↘↗↖↖←↗↖↖↖↖↖↖←→→↖↖↖↖↘↘↖←←↘↘↘↘→→→↘↘↖↘↘←↘↘↘←←↖←←←↖→→→→→→→→↘→→↖↖←←←←←↘↘←←↘↘↘←↘←↘→→↖↖↖→↘→→→↖↖↖↖↙←↖↖↖↖↖↖↖↖↘↘↘→↘↘↘↘↘↘↘←
←↘↘↘↘↘↘↘←←↖↖↖→↖↖↖↖↖↖↖←↖↖→→↖→→↖→↘↘↘↘↘←→→↘↘↘↘↘↘↘↘↘←←←←↖↖→←↘→↘↘↘↘→→↖↖→↖↖↖↖←↘↘←←←↘↘←←↘↖←→→↖↖↖↘→→→→↖↖↖←←↖↖↖↖↖←←←←→↘↘↘↘↘↘↘↘↘↘←
←↘↘←←↘↘↘↙←↖↖↖↘↘←←←←↖↖←←←→→↖→→→→↘↘↘↘←↘↘↘↘↘↘↘↘↘←←←↘←←↖↖↖↘↘←↘↘↘↘↘↘→→→→↖↖↖→↘↘↘←←↘↘←←↘↘←↖→↖←↖→→↖↖→→↘↘↘←←←←↖↖↖←←←←↘→↘↗→→→↘↗↘↗↖
↖←↘↖←↘→→↖↖←↖→→↘↙←←←←←←←←←↖→→→↘↘→→↘↖↖↘↘↘↘→→↘↘↘↙←←↖↖↖←←←→↘↘↘↘↘↘↘↘←→→↖↖↖↖→↘↗↗↖↖↗↖↖↖↗↖↖←↘←↖↖→→→↖↘↘↘↘↘←←↖←←←←←←↘←↘↘→→→→↘↘↘→→↖
←←↖→↖↖→→→↖↖↖↖→↘↘←←←←←←↖↖↖↖→→↘↘←←→→→↖↘↘↘↘→→↘↘→↖←←↖↖↖←←←↘↘↖↘→→→↘↖←←↖↖↖↖↖→→→→↖↖→↖↖↖↖↖↖→↖↖↖↖→→→↘→↘↗↗↖↖↖↖↖↖←←↘↘←←←←→→→↘↘↘↘←↖↖
←←←↖↖↖↖↖→→↖←←↘↘↘←←←←←←↖↖↖↖→↘↘↘↙←→→↘↘↘↘↘↘→→→→→→↖↖←←←←←←←→→→→→↘→↖↖←↖↘↙←↖→→→→↖→↖↖→↖↖↖↖→→↖↖↖→→→↘←→→→↖↖↖↖↖↖↖→↘↘↙←←↖→→→↘→↘↘←←←
←↖↖←←↖↖↖→↘↙←↘↘↘↙←↖←←←↖↖↖↖↖↘→→→↖↖→↘↘↘↘↘↖↖→→→→→→↖↖↘←←←←←←↘↘↘→↘→↘↘←↖←↘↖↖↖→↖→→→↖↖↖→→↖↖↖→↖↖↖↖↘↘→→↖↖→→↖↖↖↖↖↖↖↘↘↘↙←↖↖→↖→→→→→↖↖←
↖↖↖↖↖←←↘↘↘↘←↘↘→↖←←←←↖↖←←←←↘↘→→→↖↘↘↘↗↖→↖↖→↘↘→→→→→↖←←←←←←←←↘↘↘→↘↘←←←↖↖↖↖↖↖→→→→↖↖→↖↖←↖→↖↖←↘↘↘↘↘←←→→↖↖↖↖↖↖←→↖→↖←↖↖↖→→→→→→↖↖←
↖↖↖←←←↘↘↘↘↘↘←↘↘←↖←↖↖↖↖↘↘←←↘↘↘←←↘↘→→→→→→→↘↘↘→↖↖→→→←←↘←←↘←←↘↘↘↘↘↘↖←←↖→↖↖↖←↙←→→↖↖→→↖↖↖→→↖↖→→→↘↘↖←←↖↖↖↖↖↖←←↘→→↖↖←←←↘↘↘→→→→↖↖
←↖↖→↖←↘↘↘↘↘↘←←←↖↖↖↖↖↖←↘↘←↘↘↘↘←←↘↘↘↘↘↘↘↘↘↘↘↘←←←↘↘→↖↘↘←←←←←←↘→↘↘→↖←←←↖↖↖↖→↖→↘↘←←↘→→↖↖→→↖↖→→→→→↖↖←↖↖↖↖→↖←←←→→→↖←←←↘↘↘←↘↘↘↘←
←↖↖→↖→↘↘↘↘↘↘←←↖↖↖↖↖↖←←↘←←↘↘↘←←←↘↘↘↘↘↘↘↘↘↘↘↖↖←←←→→→→↗↖↘↘←←↘←↘↘↘→↖↖←←←↖↖↖↖→→↗↖↖↖→↖↖↖→↖↖↖↖↘→→→→←←↖↖←←←←→↘↙←↘↘↘↘←←←↘↘↘↘↘↘↘↘↙
↖↖↖→→→→→↘↖↘↗↖←↖↖↖↖←←←←←←↘↘↗↘←←←←←↘↘↘↘↘↘↘→→→↖↘↖←→→→→→↘↘↘←←←↘↘↘↘→↖↖↖←←↖←←↖↖→→→↖↖↖↖↖↖↖→↖←↘↘←↘→→↖↖←←←←←←↘↘↘←↘↘↘←←←←↘↘↘↘↘↘↘↘←
↖→→→→→→→→→→→↖↖↖↖↖←←←↘↘←←↘↘↘↘←←←←←↘↘↘↘↘↘↘→→→↖→↖↖↖↘↘↘↘↘↘←←←←→→↗↖↖↖↖↖↖↖↖↖↖↖↖→→↖→↖↖↖→↖←↘↖←↘↖←↘→→→↖↖↘←←←←↘↘↘↘↘↘↙←←←↘↘↘↘↘↘↘↘↙←
↖→→→→→→→→→→→→↖←↖↖←↖←↘↙←←↘↘↘↘←←←←←↘↘↘↘↘↘←←→→→→↖↖↘↘↘↘↘↘↘←↖↖←→→→→↖↖↖↖↖↖↖↖↖↖←↖↖↖→→↘↘↘↘↘↘←↖→↘←↘↘↘↘↘←←↖←←←↘↘↘←←↘↘←←←↘↖↘↘↘↘↘↘↖←
←→→→→→→→→↖→→→↖↖↖↖←←←→↖↖↖→↘→↗↖↖↖↖←↘→→↘↘↘←←←→→→→↘↘↖→↘↘↘↙←←←←↘↘↘←→→↖↖↖↖←←↖↖↖↖↖→→→→↘↘↘↘←←←↘↘↘←↘↘↘↘↖←←←←←↘↘↘←←↘←←←←←←↘↘↘↘↘↘←←
←↖→→→→→→→→→→→↖↖←←←←←↖→↖→→→→→↖↖↖↖→↘↘↘↘↘↖↖←←←↖→→↖↘↘↘→→→↖↖↖↖←↘↘←←↘↘↖↖↖↖↖↖↖↖↖↖←↘↘→→↘↘↘↘↖←←↘↘↘←↘→→→↖↖←←↘↘↘↘↘↙←←←↘←←←←↘↘↘↘↘←←←
↖↖→↖↖→→→→→→→→→←←↘↖←↖↖↖↖→→→→↖↖→↘←↘↘↘↘→→→↖↖↖↖→↖→→↘↘↘↘→→→↖←←↘↘←←←↘↖←↖↖↖↖↖↖↖↖↖←↘←→→→→↘↘↘↘↘↘↘↘←↘↘↘→→↘←←↘↘↘↘→↖↖←↘←←←←↘↘↘↘↘↘↘↘↙
↖→→→↖→→→→→→→→→↖↖→→←←←←→→→→↖↖→↘↙←↘↘↘↘↘→→↖↖↖←↘↘↘↘↘↘↙←↘↘↘←←←↘←↖←←←↖↖↖↖↖↖↖↖↖→↘↘←←←→→→→↘↘↘↘↘↘↘←←↖↖→↘↖↗↘↙←→↖→↖↖↘←←←←←↘↘↘↘↘↗↘↘↙
↖→→→↙↘↘↘↘→→→→→→↖→→↖←←←←↖↖↖↖→↘↘↖↖↘↘↘↘←←→↖↖↖←↘↘↘↘↘→↘↘↘↘↙←←←←↖↖↖↖↖↖↖↖↖↖↖↖↖←↘→↖↖↖↖→→→→↘↘↘↘↘↘←←←→↖→↘→↖→↖↖→→→↖↘↘↘←←←←↘↘↘↘←↖→↘↙
↖↖→→↘↘↘↘↖→→→→→→→→→↖↖↖↖↖↖↖↖↖→↘→→↘↘↘→↘↖←←←↖↖↘↘↖↗↗→→→→↖→↖↖→↖↖↖→→↖↖↖←←←←↖↖→↘←↖→↖↖↖↖→→→→→→↘↘↗↖↖↖↖↘↘→↖↖→→→↖↖→→→→↘↙←←↘↘↙↘↖←←↘→↖
↖↘↘→→→→→→↖→→↖↖↖→→↖↖↖↖↖↖↖←←↘↘↘→↖→→→→→↖←←←↖↖→→→→→→↘↘→→→↖↖↖↖↖↖→→↖↖↘←←←←←←↘↘←←↖↖↖←←↘→→→→→→→→↖↖↖↖↘↘→→↖→↘↘↖↖→→→→→↖↖←↘↘↘←←↖↙←→↖
↖→↘→→→→→→→↖→→↖↖→→→↖↖←←←↘↘↘↘←↘↘←↘↘→→→↖↖↖←↖↖→→→→→→↘↘↖→→↖↖↖↖↖↖→→→→↗↖←←←↖↖←↗↖↖↖→↖←←↘↘→→→→→→→↖↖↖→→→↖↖↘↘→↖↖↖↖→→→→→↘←↘↘↙←←←←←→↖
←↘→→→→→→→→→→→→→→→↘↘←←←↘↘↘←↘↘←←←↘↘↘→→↖↖→↖←←↘↘←↘→→→→↖↖↖↖↖↖↖↖←↖→→→→↖↖↖↖↖↖↖→↖↖→→↘↖←↖→↘→→→→→→↖↖↖→→→→↖→↖→→↖↖↖↘→→→↘↘←↘→↖←↖←←↖→↙
↖→↘←↘→→→→→↘↖→↘→→↗↘↘↙←←↘↘↘↖↘↘←←↘↘↘↖→→↖↖→↖↖↗↘↘↖←↘↘→→→↖↖↖↖→↖↖↖↖→→→→↖↖↖↖←↖↖↖↖↖→→→↖↖→→→→→→→→→→↖↖→→→↖→→→↘←←←↖→→→→→↖↖→→→↖↖↖↖↖→↖
↖↘↘←←↘↘↘↘↘↗↖→→↖→→→↘↙←←↘↙→→→↗↖↖↘↘→↖↖↖↖↘↘↖↖→→→↖↖↘↘↘→→↖↖↖↖↖↖↖↖↖↖→→→↖↖↖↖←←↖↖↖↖↘↘↘↘←↘←→→→→↖↖→→↖→↘→↖↖→↘↘↘↖←↖↖↘↘→→→→↖→→→→→↖↖↖→↖
←↘↗↘←↘↘↘↘→→→→→→→→→→↘←←←↙←→→→↖→→↘→↖↖↖→↘←←↖↖→→→↖↘↘↘→↖↖↖→↘←←↖↖↖↖←→→↖↖↖↖↖↖↖↖↖↘↘↘↘←↖↖↖←→→→↖↖→→→→→↖→↘↘↘→→↖↖←←↘↘↘→→→↘↘→→↖→↖←←←←
←↘↘→↖→↖↗↘↘←←↖↘↘↘↘→↘↘↘←←↖←→→→↖→→→→↖↖→↘↗↖↖↖←→→→↘↘↘→↖↖↖→↘↖↖↖↖↖↖↖←←↖↖↖↖↖↖↖↖↖↘↘↘↘↘←↖→↖↖↖→→↖→↘→→→→→→↘↖→→→↖→↖←↘→↘↘↘↖↘↘→↖↖→↘↘←←←
←→→→↖→→→→→↖←↘↘↘↘↘↘↘↘↙←←←←↖↖↖→↘↘↘↙←↘↘→→↖↖←↖→→→→→→↖↖↖→↘→→↖↖←↖→→→↖↖↖↖↖↖↖↖→↖→↘↘→↖↖←↘←←←→→↘↘↘→↖↖→→→→↖→↖→→→→↖↖→→↘↘↘↘↘←←↘↘→↖↘↘←
←→→↖→↖↖→→→→←↘↘↘↘↘↘↘→↖←←←↖↖↖→→↘↗→↖←↘←→→→↖↖←←→→→→→↖↖↖→→→→↖↖←↖→→→↖↖↖↖↖↖↖←↘↘→→→→↘↘↘↘←←←↘↘↘↘↘→↖↖→→→→→↖↖↖→→→→↖→↘↘↗↗→↖↖↖↘↘↘↘↘↘↙
↖→↖↖↖←←↘↘→↘↖↘↘↘↗→↘↘↘↘←←←↖←←←↘→→→→→↖←↘↙→→↖↖←→→↘↘→↖↖↖→→→↖↖↖↖↖→↖↖↖↖↖↖↖↖↖↖→↘→↘↘↘↘↘↘↙←←←↘↘↘↘→→↘↘↘↘→→→→↖←↘↘→→↖→↘→→→→→↖→→↘↗↘↘↘↙
←↘↘↘←↘↘↘↘→→→↘↘↘↘→→→↘↙←←←←←↙←→→→↘↘→↘←←←↖↖↖↖↖↖→→→↖↖↖→→→→→↖↖↖↖→↖↖↖↖↖↖↖↖↖↖→↘↘↘↘↘↙↘→↖↖↖←↘←↘↘↘↘↘↘↘↘↘↘→→→↖↘↘↘←↘↘→→→→→→↖→→→→→↘↘↙
←↘↘←←↘↙←↘↘↘→↘↘↘↘↘↘↘→↖↖←←←←←←←↘↘↘↘↘↘←←←↖→↖↖↖↖→→→↖↖→↖→→→→↖↖↖↖→→↖↖↖↖↖↖↖↖←↘↘↘↖↘↘↘↘↘←←←←↘↘↘←↘↘↘↘↘↘↘↘↘↘↘←↘↘↘←←↘→→→→→→→↖→→↘↘↘↘↖
←↘←←↘↘↘←↘↘↘↘↘↘↘↘↘↘↘↘→↖←←←←←↘↘↘↘↘↘↘↘↙←←↖↖↖↖→↘→→↖↖→↙↖↖→→↖↖↖↖↖↖→→↖↖↖↖↘←←↘↘↘↘←↘↘↘↘↘←←←←↘↘↘←←↘←↘↘↘↘↘↘↘↘←↘↘↘↘↘←←→↖→→→↖↖↘↘↘↘↘→↖
←←←↘↘↘↘←↘↘↘↘↘↘↘↘↘↘←←↘↖↖←←←↘↘↘↘↘↘←↘↘←↖←↖↖↖↖→→→→→↖→↙←↖→→↖↖↖→→↖→→↖←←↘↘←←↘↘↘↘←↘↘↘↘↘↘←←↘↘↘↘←←←↘↘↘↘↘↘↘↘←←↘↖→↘↘←↖→→→→→↖→→→→↘→→↖
↖↖↖→↘↙↘↘↘↘↘↘↘↘↘↘↘↖↖↖↖↖↖↖↖←↘↘←↘↘↖←↘↙←←↖↖↖→↘↘↘↘↘←↖→↖↖←↖↖↖↖↖→↘↘←→→↖←↘↘←←↘↘↘↘←←↘↘↘↘↘↘←↘↘↘←←←↘↘↘↘↘↘↘↘↘←←←←←↘↘↙←↖↖→→→→↘↘↘→→↗→↖
↖↖←↘↘↘↘↘↘↘↘↘↘↘↘↘→→↖↖↖↖→→↖↖→↘↖↘↘←←↘←←←←↖←↘→↘↗→↗↖←→↖↖↖↖↖↖↖↖↘↗↗↖↖→→→↘↘↖←↘↘↘↘↘←↘↘←↘↘↘←↘↘←←←←←↘↘↘↘↘↘↘↘↖←←←↘↘↘↖↖←↖→↘↘↘↘↘→→→→→↖
↖↘↘↘↘↘↘↘↘↘↘↘↘↘↘↘→↖↖↖←↘↘←↖↖→→↘↘↘←←←↖←↖←←←↖→→→→→↖↖←↖↖↖↖↖→↖↖→→↖↖→↖→→→→→↖←↘↘↘↘↘↘←←↘↘↘↘↘←←←←←←↘↘↘↘↘↘↘↘↖↖←←↘↘↘↖↖↖←↘↘↘↙↘→↖→→→→↖
←↘←↘↘→↗↘↘↗↘↘↘↖←→↖↘↘←←↘←←←←↘↘↘↘↘↖←←↖↖↖↖←←↖↖→→→→→↖↖↖↖↖↖↖↖→→→↖↖↖→→→↘→→→↘↘↘↘→↘↘↙←←↘↘↘↘↖↘←←←←↘↘↘↘↘↘↙←↘↘←←←↘↘↖↖↖↖↘↘→→↖→→→→→→→↖
←←←↘↘↘↘↘↘→↘↘↘↙←↖↘↘↘←←↘←←←↘↘↘↘←→↖↖↖←←↖↖↖←↖→→→→→→↖↖↖↖↖↖↖←↘↘↘←←↘↘↘↘↘↘→→↗↘↘↘↘→→↖←←↘↘↘←↘↘↘↘←←↘←↘↘↘↘↘↘←↘↖←←↘→←←←←↘↖→→→→→→→→→→↖
←←←↘↘←↘↘↘↘↘→↘↘←←↘↘↘↘←←←←←↘↘↘↙←↖↖↖↖↖←↖↖↖↖←←→→→→↖↖↖↖→↖↖↖←↘↘↘↘←←↘↘↘↘↘↘↘↘↘↘↗→→→→↖↘↘↘↘↘↘←←↘↘←←←←↘↘↗↘↙←→↖↖←←↖↖↖↖↘↘↘←→→→→→→→→→↖
↖←←↘↘↘←↘↘↘↘↘↘↘↘←↘↘→↗↖↖↖↖←↘→→↖↖↖↖↖↖↖↖↖←←←←↖↖↖→→↖↖↖→↗↖↖↖←↘↘↘↙←←↘←←→↘↘↘↘↘↘↘→→→→→→↘→↘↘↘↘←↘↘←←←←↘→→→↖↖↖↖↖↖←←↖↖↖→↖↖↖↖→↖→→→→→→↖
↖↖←↘↘↘←←↘↘↘↘↘↘↘↘↘↘→→→↖↖↖↖↖→→↖↖↖↖↖↖↖↖↖←←←←↖↖↖→→→↖↖→→↖↖↖↖↘↘→↖↖↖↘↙←→↘↘↘↘↘↗↖→→→→→→→→→→→↗↖↘↘↘←←↘↘↘↘↘↘←←←→↖↖↖↖↖←→→→↖↖↖↖→→→→→→↖
←←↘↘↘↘↘←↘↘↘↘↘↖↘↘↘←←←↖↖↖↖↖↖→→↖↖←←←←↖↖↖←↖↖↖←←←←↖→→↘↘↘→→↖↖→→→↖↖↖→↘←↘↘↘↘↘↘↘↘↖↖→→→→→→→→→→→→↘↖↘↘↘←←↘↘↘←←←←↖↖↖↖↖↖↖→→↖↖↖↘↘↘↘↘↘↘←
←←↘↘↘↘↘←←↘→→↘↘↘↘↘←←←←↖↖↖←↘↘↘↘←↖←←←←←↖↖↖↖↖←←↙←←→→↖→↗↖↖↖↖→→→↖↖→→→↘↘↘↘↘↘↘←↘↙←↘↘→→↘→↘↘←↘↘↘→↖↘↘←←←↘↖←↖←←←←↖↖↖↖↖↖→→←←←↖→→→↘↘↘←
←←↘↘↘↘↘←←↘→→↘↘↘↘←←←↖↖↖↖↖↖↘↘↘←←←←←←←↖↖↖↖↖←←←←←←↘→→→→↖↖↖↘↘↘→→↖↖→→↘→↗↘↘↘↙←←←←↘↘↘↘↘↘↘↘↙←↘↘→↘↘↘←←←↘→↖↖←←←←←↖↖↖↖↖→→↘←←←→→→→↘↘↙
←↘↘↘↘↘↘←←↘↘↘→→↘↘↖←↖↖↖←↖↖↖→→↗↖←↘←←←←←←←↖↖↖↗↖←←←←↘→→↖↖→→↘→↖→→↖←↘↘→→→→↘→↖↖↖↖↘↘↘←↘→→→→↖↖↘↘↘↘↗↗↖←↖↖→→↖↖↖←←←↖↖←←→→→→↖←↙←→→→→↘↖
←↘←←↘↘↘↙←←↘↘→→→→↖↖←←←←↖↖↖→→→→↘←↘←←←←←←←↖→→→←←←←←←↖↖↖→→→→↖→→→→↘→→→→↘→→↖↖↖→↘↘↙←↘→→→→→→↘↘↘↘→→↖↖←←←→↖→↖↖←←←←←←←→→→↖←↘←←↘→↘→↖
↖↙←↖→→→↖↖←←→→↖→→↖↖↘←←←↖↖↖→→→↘↙←→↖←←←←←←←←↘→↖↖←←←←←↖↖→→→→↖→↘↘↘↘↗↖→→→→→↖↖↖→↘↘↘←↘↘→→→→→↘↘↖→→→↖↖↖←←↖↖→→↖↖↖↖←↖←←←→→↘↘↘↙←↘↘→→↖
←←←←↖→→→↖↖↖↘↖↖→→→↖→↖↖↖←↖↖→→→↘↙←←←↖←←←←←←←←→↖↖↖↖↖↖↖↖↖→→→→↘↘↘↘↘↘↖↖→→→→→→↖←↘↘↘↖↘↘←←→→→→→→→→→→↖↖↖↖↖↖←→→↖↖↖↖↖↖↖↖↖↘→→↗→↖↘↘→→→↖
←←←←←↘→→→↖→→↖↖←↖→→→↖↖↖←←←↘↘↘↘↖←←←←↖←←←←←←←↖↖↖↖↖↖↖↖↖↖↘↘↘↘↘↘↘↘↘←←↖→→→→→→→↖↘↘→→→↗↖←→→→→→→↘↘→→↘←←↖↖↖↖↖↖↖←←←←↖↖←←↘→→→→→→↖→→→↖
↘←←←←←←→↖↖→→↖↖↖↖→→→↖→↘←←←↘↘↘→↘↘↖←←←←←←←←←←←↖↖→→↖↖↖↖↘↘↘↘↘↘↘↘↘←←↖↖→→↘↖↘→→↘↘→→↘↘↘←↖→↖→→→↘↘↖↖→→↖↖↖↖↖↖↖←←←←←←←←←←←→→→→→→→↖→→↘
↖←←←←←←→→↖→→↖↖↖↖↘↘↘↘↘→↖←←↘↘↘↘↘↘←←←↖←←←←←←←↖↖↖→→↖↖↖↖→→→→→→↗↗↖↖←←↖→↘↘↘↘↘→↘↘→→↘↗↖←↖→→→→→→→↖↖→→→↖↖↖→↖←←←←←←↘←←←←↖↖→→↖→→→↖→↘↘
→↖↖↖←←←←↘←←→↖↖↖→↘↘↘↘↘←↖↖←↘↘↘↘↘←←↖←↖↖←←←←←←↖←↖→↖↖↖↖↖↘→→→→→→→→↖↖↖↖→↘↘↖↘↘↘↘↘→→→→↖↖↖→→→→→→→↖→↖↖→↖↖←↘↘↘←←←↖↖←←←←↖↖→↘↘←→→↖↖↘↘→
→→↖↖↖↖↖←←←↖↖↖←↘↘↘↘↗↘↖←←←↘↘↘↘↘↘←←↖↖↖←←←←←↖←←↖←↖←←←←↘↘←←→→→→→→→↖↖↖→↘→→→↘↘↘←↖→→→↖↖↖→→→→→→→→→→↖→→↖↖→↘↖←↖↖←←↙←↖↖↖←↘↘↘←←↖↘↘↘→→
→↖↖↖↖←↘↙←←←↘↖↖↘↘↘→→→→↖←↘↘↘↘↘→↖↖↖↖↖←←↖↖↖↖↖↖↖←↘↘←←←←←↘↘↘↘↘↘↘→→→→↖←↘↘↘→→↘↘↘←←↘→↖↖↖↖↘↘→→↘→→→→↖↖→→→↖→→↖↖←←←↖↖↖↖←←←↘↘←←←↘↘↘↘→→
→→↖↖↖←←↖←←←↘←←↘↘↖↘↘↘↘←←↘←↘↘↘→→↖↖←←←←↖↖↖↖↖↖↖←↘↘←←←←←↘↘↘↘↘↘↘←↘→→→→↘↘↘↘↘→→↖↖↖→→↖↖→→→↖↘↘↘↙←→→↖↖←→→→→→→↖↖↖↖→↖↖←←←↘↘↘←←←↘↘↘↘←→
←→→↖↖↖↖↖↖↖←↘↘←↘→→↘↘↘←↖←↘←←↘↘↘↘←←↖←←←←←←↖↖↖↖←↘↘↘←←←←↘↘↘↘↘↘↘←←←→→→→↘↗→↘→→→↖↖↖→→←↘→→→↘↘↘↖←→↖↖↖←↘↘→→→→→↖↖↖↖←←↘←↘↘←↘↘←←↘→→↘↘←
↖↘↘↖↖↖↘↘←←←↗↘↘←↘↘↘↘←↘↘↘↘←←↘↘↘↘←←↖↖↖↖↖↖←↖↖←←←←↘↘←←←←↘↘↘↘↘↘←←←←←↘→→→→→→→→→↖→→→→↖→→↘↘↘↘→↖↖→→→↖↖→→→→→→↖↖←←↘←←←←↘←←↘↙←←←→→→↖↖
←↘↖↖↖→↘↖←←←→↘↘←←↘↘↘↙↘↘↘←←←↘↘↘↖↖↖↖↖↖↖↖↖↖↖↖←←←↘↘↘←←←↘↘↘↘↘↘↘←←←←←↘↘↘→→→→→↘↘↖↘↘↘↘→↖↘↘↘↘↘←←←←←↖↖↖→→↖→↘→↖↖↖↘↘←←←←←↖↖→↖↖←←←→→→↖
↖↘↙←↖↖→↖↖↖↖↘↘↘←←↘↘↘↘↘↘↘←←↙↘↖↖↖↖↖↖↖↖↖↖↖↖↖↖←←←↘↘←←←←↘↘←←↘↘↘←←←←←↘↘↘↘↘↘↘↘↘↘←↘→→↖↘↘↘↘↘↘↘↘←←←←←←←→→→→→↖↖↖→↘↘←←↖←←←←←↖↖↖←←←→→→
↖→↖↖↖↖→→↖↖→↘↘↖↘↘↘↘←←↘↘↘↘←←←↖↖↖↖↖↖↖↖↖↖↖↖↖←←←←↘↘←←←←↘↘↘↘↘←←←←←←←←↘↘↘↘↘↘↘↘↙←↘↘→→↘↘↘↘↘↘↘↖←←←←←←←←→↘↘→→↖↖→→→↖↖↖←↘↘←←←←↖↖↖←↘↘→
↖→↖↖↖↖→→↖↖→→→↖→↘↘↘↙←↘↘↘↘←←←↖↖↖←←←←↖↖↖↖↘←←←←↘↘↘↖←←↘↘↘↘↘↘←←←←←←←←↘↗↖→↘↘↘↘↙←↗↖↖↘↘↘↘→→↗→→↖↖↖←↘←←←→→→→↖↖↖→→→↖↖↖↘↘↘←←←←→↖←←↘↘↙
↖→→↖↖↖→→↖→→→→→→→↘↘↖←↘↘→↗↖↖↖↖↖↖↖↖←↖↖↖←↘↘↘←←←←←←↖↖←↘↘↘↘↘↘←←←←←←←←↘↘←←↘→↘→↖↖↘←↘↘↘↘↖→→→→↖↖→↖←→↖↖↖→→→↖↖→→→→→→↖↖→↘↙←←←←↘↙←←↘↘↖
↖→→→→↖→→→↘↘↘→→→→↗→→↖↗→→→↖↖↖↖↖↖↖↖↖↖↖←←↘↘↘↘↘←←←←↖↘↖↘↘→→↖↘↘←←←←↘←←↘←←←↘→→→→↖↘↘↘↘→→→↖→→→→←↘↖←→↖↖↖↖→↖↖↖→→→→→→→→↘↘↖←←←←←←↖→↘↘↙
↖→→→→↖↖→↗↘↘↘↘←↘→→→→→→→→→↖↖↖↖↖↖↖↖←←←←←←←←↘↘←←←←←↘←↘↘↘→→→↘↖←←←↘←←←↖←→↘↘↘↘←↘↘↘↘↘←→→→→↖→→↖→↖↖↖↖↖↖↖→↖↖←↘↘↘↘↘↘↘↘↘↘↖↖←↖↖←↖↖→→→↖
↖→→→→→→→→→→→→↖→→↘→→→↖↖↖→↖↖↖↖↖←←←↖←←←←←←←↘↘↘←←←←←←↘↘↘↘↘↘→↖↖←←↘←←↖↖↖→↘↘↘↘↘↘↘↘↘↙←↖→→↖↖→→→↖↖↖↖↖↖↖↖→→→←↘↘↘↘↘↘↘↘↘↘←←↖↖↖↖↖↘↘→→↖
↖→→→→↖→→→→→→→→→→→→↖→→↖→↖↖↖↖↖↖←←←←←←←↖←←←↘↘↘←←←←←←↘←↘↘↘←→↘←←←↘↙←↖↖←↘↘↘↘↘↘↘↘↘↘↘←←←↖→→→→→↖↖→→↖↖↖↖→→→↘↘↘↘↘↘↘↘↘↘↖↖↖←↖↖↖↖→↗→↖↖
←↘→→→→↖→↖↖→→→→→→→↖↖→↖↖→↖↖←←←↖↖↖↖↖←↖↖↖←←←→↘↗↖←←↖↖↘↙←→↘↖←↘↘↖←←←↖←←←←←↘→→→→→→↘↘↘←←←←↘←→↖→→↖→→→↖↖←↘↘↘↘→↖→↘↘→↘↘↘↖↖↖←↖↖←←→→↖↖←
←←↘→→→→→↖↖→→→→→→→→→→↖↖→→→↖↖←↖↖↖↖↖↖↖↖↘↘↖←→→→↖↖↖↖→↘↖↖↖→→↖↖↖↖↖↖↖↖↖↖←↖←↘→→→→→↘↘↘↘←←←↘↙←↖←↘←←↖→→↖↖↘↘↘↘↘→→→→→→↘↘↖↖↖↖↖↖←←←↖→→←←
←←←→→→→→↖→→→→→→→→→→↖↖↖→→→→↖↖←←←↖→↖←←←←↖↖→→→↖↖↖↖→→↖↖↘→→→→↖↖→↖↖↖↖↖↖↘←↘↘→→↘↘↘↘↘↘←←←←←←←←↖↖↖↖→→→↖→→→→↖↖→→→→↗↘↘↖↖↖↖↖↖↖↖←←→→↖←
←↖↖↖↖→↖↖↖→→↘↘↘→→→→→→→↖↘↘↘→↖↖↖↖↖←←↘↘↘←←←↖↖→→↖↖↖→→→↖→→↖→→↖↖↖→↖↖↖↖↖↖↘↖→→→→↘↘↘→→↖↖↖↖←←←←↖→↖↖↖↘→→↖↖→→→↖↖→→→→→→↖←↖↖↖↖↖↖↖↖←↘↘↘←
↖↖↖↖→→↖↖←↘→→↘↗→→→↖↖→→↘↘→→↖↖↖↖↖↖←↘↘←←↖↖←↖↖→↖↖→→→→→→→→↖↖↖↖↖↖→→→↖↖↖→→↘↘↘↘↘→→→→→→↖↖↖↖←←↖↖→↖↖←↘←→→→↘↘←←↘↘↘→→→→→↖↖↖↖↖↖↖→↘↘←↘↘←
↖↖↖→→↘↘←←→→→→→→→→→↖→→↘↖→→↖↖←←↘←←↘↗↖↖↖↖↖↖↖↖↖→→→→→↖↖→→↖↖↖↖↖↖→↘↘←↖←↘↘→↘→↘↘↘↘→→→→↖↖↖↖↖↖↖↖↖→→↘↖←↖↘↘↘↘←↘←←→→→→→→→↖↖←←←←↘↘↘←↘←←
↖↖↖→→↗↖↖←↘→→→→→→→→→→→→→↖→→↖←←←↖↖↘→↖↖←←↖←↖↖↖→↖↖→→↖↖→→↖→→↖↖→↘↘↖←←←←↖→→↘↘↘↙↘→→→→↖↖↖↖↖↖↖↖↖→→→↖↖↖↘↘↗↖↘↘←←←←→↘↘→→↖↖←←←←↘↘↘↘↘←←
↖↖→→→→→↖↖→→→→↘→→→→→→↘↘→↖→→→↙←↖↖↖↖→→↖←←←←←←←←←↘↘→↖↖→↖↖→→→↖→↘→↖↖←←↖↖↘↘↘↘↘↖→→→→→→↖↖↖↖↖↖←←→→→→←↘↘→→↘↘↘←←←←↘↘↘↘←↖↖↖↖←←↘↘↘←↖↖↖
↖↖→→→→→→←↖→↘↘↘↘↘→→↘↘↘→→↖→→→↖↖↖→↖↖→→↘←←←←←←←↘←↘→↖↖↖↖↖↖→↖↖↘↘→→↖↖↖↖↖↘↘↘↘↘↘←↘↙←→↖→↖↖↖→↙←←←↘↘↘↘↘←←→→↘↘↗↖↖←↘↘↘↘↗↖↖↖↖↖←←↘↗↖↖↖↖↖
↖→↖↖→→→↖↖←→↘↘↘↖↘↘↘→→→→↖↖→→→↖↖↖↖←←←→→↖←↖↖↖←←↖←→↖↖↖↖↖↖↖→↖→→→→→↖↖↖↖→↘↘↘↘↘↙←↘↖←↖↖↖↖↖↖→↖↖←↘↘↘↘↘↘←←↘→→→→↖←←↘↘←↘→↖↖↖↖↖↘←←←↖↖↖↖↖
↖↖↖→→→→→←←↘↘↘→↘↘↘↘→→→→↖↖→→→→↖→↖→↖←←→↖↖↖↖↖←←←↖↖↖↖↖↖↖↖↖→→→↘↘↘→→↖↖↖↘↘↘↘↘↘↖←↘←↖↖→→↖↖←→↖↖←↘↘↘↘↗↖↖↖↘↘→→→↖→↖↘↙↖→↖↖↖↖↖→↗↖↖↖↖↖↖↖↖
↖←↖→→→→→↘←↘↘→→↘↘←←→→→→↖↘↘←↖→→→→→→↘←←↖↖↖↖↖↖←←↖↖↖↖↖↖↖↖↖→↘↘↘→↘↘→↖↖↘↘→→→→→→→↖↖←←↘←↖↖←←↖↖↖↘↘→→→→↖↖↖↗→→→↖→→→↖↖→→↖↖↖↖→→→↖↖↖↖↖↖↖
↖↖↖→→→→→→↗→→→→→↖↖↖↖↖→→→→↖↖↖→→→→→→→↖↖↖↖↖↖↖↖↖↖↖↖↖↖↖↖↖↖↖→→→→→→→↖↖↖→→→→→→→→→→↖↖↖↖↖↖↖↖↖↖→↖→→→→↖↖→→→→→→→→→→→↖↖→→↖↖↖↖→→↖↖↖↖→↖↖↖
