↘←←←→←↘↘←←↖↖←→→←→→→←←↖→↖←←↖↗→→→←←↘→↙→→↖↘→←←→←→↖←→→
↖←→←↖↗←↗↖←→←→↖←←↖→→→←↙→→→←←→←↖→←←→←←→→→↘→←↘←←↖←↘←←
→←↖←←→←←←↘←↖→←←←→→→→→→→→→←←→←↖→←←→↖←→←→→↖↖↖←→→→↖↖←
↘→←←↖↖→↗←←←↖→→→→←→→←←→→←→←→↙↘↖←↖←←→→←↖→←↖→→←←→→←←↘
←→↖→→→←←←→→↖→↘↘→←←↗↘←←←↘→→→→←→→→→→→→←↙→←→→←↖→→←↘↘←
↖→→→→↖←←↖↗→↖←→←↗↗↖←←→→←→→↘→←↖↖←→↖↗←→←→←→←↖→↖↘←↙←↗↖
←↘←↖→→→→←→→←←↖←←→←→↖↖→→←↘→←↘←→→→→→←↘↘←↘→←←←↖→←↖←←→
←↘←↖→←→←→←↘←↘↘←↖→→→←←→↙←←→←↖→↖→↘↘←←↘↖↖←↖↖↗←↖→←→←↖↗
→→→↖←↘↘↘↖←↘→←↗←↙→→←←↘↘↖←↖↗←→→←→↖↖↖←←→←→→→→←↖→→↖←←→
→←←→→→↗←↙→→→→↖→←↖←↘↘↖→←←←↘→→←→↖←←→←↖→→↘←→→←→←→↖→↘←
↖←↖↖←→→←↘←←←→←↘→↙←→←↖↖↖←↖→→→→←→←↖←→←↖→←↖↖↗↖↗↘←←→←←
→→←↙←→←→→←←↖↗←↘←↖→→←↖←↖←↙→↖←←↘→←←←↘→←→→←→←←←→→←→←→
→↖←↖←↘←←←→←←→←→←↖→←→←→←←←←→←←→→→↘↘←↙↘→→←→→←↖↗→→↖←→
←→←↖→→←←→→→→←→→←→→→←→↖←→↘←←↘↖↖→→→↖←↖→←↖→←↘→←→→→↘→→
←←→→→←↗↖→←←↖←←↘←→→↖←←↙→←←↖↖→←→→↘→↘←→↘←←↘←→←←←→→↖←←
↘←←←↖←→←←→↖↘→→→←←→→↖←↙↘←→←→↗↗↘←↘↖↘←←→↘←←→←←↖→↘→←↘←
←←↘→←↖→←↘↘←↖↘←↙←↖↖←→←←←↘←←↘↖←→↖↖→←↘←↖→←←↖←←↖→→↖←↗↖
↖↖→→→↗↖←↘↖↖→↖←↖←↘↘↖←↖←→↘↖←↖←↖←↙→←←→→←→←←↙↖←→→→←←↘→
←→→←←←→→↘←←←→→↖←↘←→←↖←↘←↘→←←→↖↖←←↖↖↙→←↖→→↖←↘↘→←→↘↖
←↖↗↖↗↖↖→→→↖↖↖→←←→↖→←↘←↘←↖←↖→↗←→←→→←↖→←→↖→←↘↘↙←↖→←↙
←←→←←←→→→→←→→→←←←↖→←↘↙←←→←↘→←→→←←←→↖→←→←←↘↘→←↖↘→→↖
→←↖←↘←←←→→↖←↘↖↘↖←↙→←←↙←↖→←↖↖←→←↘↘←→→←←→↙→←←←→↖←↖↘↘
↙←↘↗↘←←↘→←→↘↖→←↖↖↖→←←↖↘↖→→←←←→→←→↖←↘←↘→↘→→↖↖←←←↖↘↘
↖→←←←↖←↖↖↖→→↖←↖↖←→→←←↙→→→→→←↖→→↖←←→↖→←←→↖←←↙←←←→←→
→→↖↖←↖→↘←↖←↘←←→→←→←←←↙←→→↘←←→→→→←←→↖→→→→↘←→←←↖↖↗←←
→←←←→↖↖↖←←↘↗↗↗↖←←→→←←→↖↘←←→←→↖→→←←→→↙→→→←↖↖→←←←→→→
↘←↖←→←←↖←←→→←←←→←↖←←←←←→↖↖↘←←←←→←←←→→↖↗↖←←→←↘↘↖←←↘
↖←↙←↘←←↖→↘←←→→←←←↘←←←↖←→↖→←↖↖↖↖↗←→↖↖→↖→←←↖↗←→←←←↖↘
←→←↘→→←↖→↖→↗↖→←←↘→↖←←←←↙←→↖←←←←→↖→←←→→↖←→←→→↖→←→→←
↗↖←↖←→↖→←↖→→→→←↘↘→←←↖→↘←←←→←←↙←↘←←←↘↘←→→↖←↖→→↘↖←→→
←→↖→←↙←→←↘↖←↘↘↘↘→↖←←→→→←←→←→←↖→←←↘←↘↘←↖→↖←↙→↘↘↘↘→↘
←↘←←←→←→→→←→←←↖↖←→→←→←↖←→←↖→→↖→↖→↖←→↖←↙→←→→←↘↗←←←↖
→←↖↖←→→←↖←←↙→↘←↖→←→←↖↖↖←→←↖→←→→←←←→→←←→→↖←←↘→←→→→→
↖←↖↘←↖←↖←↘←↖←↖↖↖←←→←↖→→→←←←↖↖↗↖←←↖→↘↘↖←→←→←↘↖←↙←→→
→←←→←←↖↙→←←←→→↘→↖→↖←↖←→↖←←→←←↘←←←→→→←↖→←→←←↘←↖↖←↖→
←↘→←←←→↖→←↘←→↖↖←←→→←→←↙↘←↖←→↘↘↗←↙→↖←→→←↖←←↘←↗←←←←→
←→↗↖↖→←→→↖↗↖↖←↖→↖→↖←↘↘←→←←←↘←↖←←→→←←↘↘↘←↖↘↖←←→→↖↗↖
←←←←→←↖↖↖→→←←↖→→→→→→→↖←↖←←↖↘↖↗↘←←↙←→↖←↖↖←←↖↖↖→→→↖←
↖←←↖→←→→←↘↘↘←↖→↖←→→←↘←↖↖↗←↘←←→←←←↖→←↘→→↖↖→←↖←→←↘↘←
↙←←↙↘→←↘←↘↖←↘→←↖←↖→→↘←→←→↘→←↖→↖↖←↖→↘↘←←→→↘↗↖↖←↘↘←←
←←←←→←↗↖↖←↖←→←→↘↖↙↖←→←↖←←←←←→→←↘←←→←→↖↖↖←→→←→↘↘←↖→
↙←↘→↖↖↘→→→→←←←↖↖→↖←↖↗←←→↘→↗↖→→←↖↗↖→→←↖→→→→→←←←↖→←↘
←←←↘↘←↘↖←↘←←←→→→→←←←→→←↘→→←→←↙←←→←→→←↖→→↘→←↖→←←↖←↘
↖→←→↖↖←←←→←↗↖↖→→↖→→←↖→→←↘↘↘↘↘←→→←←→↗←↙→→→↖→→→←←←←↘
↖←←→←→↖←↖→→←←→→→↙←↖→→↘↘←↘→→←↖↖↖→←→→←←←←↘→←↖↖→→←←↘↘
←←←↙←→→←←←↖↖←←→→→←↖→→→→→←←←→→←→→←←→→↘↖↘↖←↘↘↘←↘←↘↘→
←←←↘←←↖→←→←→↗↖↖→↖→→→→→↖←←←↖↖→↖→←←↖↖→↘↖←↙→↖←↙←→←↖→←
↖→→↘←↖→↖←→←↘→←←→←↘←↘↖←←→→←←→←→→↖→←→→↘↙←↖←←←↙←↘↖←→↖
↖→→↘←↖←→↖→→↘←←↘↘←←←←←←↖←↘→←←→←←→→←→←→↘↘←→←←→←↘←←↖→
→→→↖←←←→←↖←↘←↖↘↖↖↖↖→←←→→←←↘←←↖←↘→←←←←↘↘←↖↖↖→←→↖←↖→
